~~~~~~~~~~~~
~~;;;'~~~~~~
~~;;'';~~~~~
~~''''';;~~~
~'''''''''~~
~;;'';;'''~~
~~;;'^;''''~
~~~;'^;;''~~
~~';;'^;;~~~
~';;'''''~~~
~;;;;~'~~~~~
~~~~~~~~~~~~